################################################
#..............#####...#........#..............#
######........................  #...######.....#
#.......................#......#......#####....#
#...####....###..........######.....####.......#
#...##....#####...............####.............#
#.........######...########............#####...#
#.....##########..###########............###...#
#........#######......................######...#
#.####..................#######.........####...#
#...................###########...........##...#
#.......######..........##########........##...#
######......#######.......................##...#
#..........................######..............#
################################################