##########################################################
#...........#...#........................................#
#.########.##.#.#.###########.#########################.##
#.#......#.#..#...#...................##.................#
#.#.####.#.#.######.####################.#################
#.#......#.#.#...........................................#
#.####.###.#.#.#.########.####..#.##################.#####
#............#.#........#....#..#.####...............#.#.#
#.############.########.#....#..#.####....############.#.#
#.....................#.......#.#....................#.#.#
######.#######.######.#########.####################.#.#.#
#....#.......#.####.#..........................#####.#.#.#
#.##.#.......#......###.#######.##############.......#.#.#
#..#.#.......#.######.#.......#...........#####.######.#.#
#..#.#######........#.#######.#.########...............#.#
#..#.........######.#.......#.#.#......#......##########.#
#....#######..........#######.....####...................#
##########################################################