#########################################
#...#####....####.............##......#.#
#...#..####........#...###....##.###..#.#
#..##.......##....##..####....##........#
#.........####....###...####..#....##.#.#
#..###......##....###...####......###.#.#
#....####....#..........####......##....#
####...###......##.......##.......##....#
###.....##....####...........#...######.#
#..............#####...###..##..........#
#########################################