##########################################################
#####.............######.............####.........######.#
####..###.#######.....#..###########.......####...#####..#
#.#..####.....#####.#...##........########..###...#.....##
#.#.#######..#####..##..#..################.######..######
#.#..........#.....####.#....########.............#...####
#..###..######..#.........##...........#########.####..###
#......#####.#.#######.###..........########.......###.###
#.####...........#####...######.####.........#########...#
#..#############..######...###..#####...###.##.......###.#
#.######.#######....######.........####........####..###.#
######.......######.........######.####...####......####.#
####.......#######..#.#####..###.#...##.#####..#####.....#
###.......#.........#####.........##.#....###.######.#####
####......#.#####.....###...#######..#..#####.........####
#####...###...#####..####.###.......##.......###.......###
#######......#######...........####...#........###.......#
##########################################################