##########################################################
#...,,................,,,..,,,,,,,.......,...............#
#.,.,..,,,,..,,,,,,,,..,,,.....,,,,......,..........,,,..#
#.,...,,,,,,,,,,,...................,,,,.,,,,,,,,,,,,.,..#
#.,,,,,,,,,,,........,,,,,,,,,,,,,,,,....,..........,.,..#
#.,,,,,,,,....,,,,,,,,,,,,.....,,.....,,.,.,,,,,,,,.,.,..#
#.,,,,,,,,...,,,,,.........,,,,,...,.....,........,...,..#
#..,,,,,,,,,........,,,,,,,,,,...,,,,,,,,,,,,,,,,.,.,.,..#
#.......,,,,,.,,,,.......,,,,,.,,,,,,,,...........,.,.,..#
#,,,,,,........,,,,,,,,.................,,,,,,,,,,,.,.,..#
#.....,,,,,,............,,,,,,.,,,,,,,,,,.........,.,.,..#
#...,,,,,,,...,,,,,,...,,,,,,,.....,,,,,..........,.,.,..#
#............,,,,,...,,,,,,,...,,,.,,,,,.,........,.,.,..#
#..,,,,..,,,,,,,,.,,,,,,,,,..,,....,,,,,.,........,...,..#
#.............,,,,,.,,,,,,..,...,,,,,,,,.,,,,,,,,.,,,,,..#
#..,,,,,,,,...,,,,,,,.......,.,,,,,,,,,,.,...............#
#,,,,,.......,,,,,,,,,,,,,...............................#
##########################################################