#####################################################
#.................#.............#...................#
######.#########..#.#######.....#...#######.#####.#.#
#...##.#########............#####...#######.....#.#.#
#...##....######..###########.......#######..##.#.###
#...##....######..............####.#########.##.....#
#.........######..###########.####.....#####.##.#...#
####..##########..###########.#####.#....###.##.#...#
####....########..............#####.#.######.##.#...#
#.####..########........###########.#...####.##.###.#
#...................###############.#.....##......#.#
######.#######..........###########.#.....##......#.#
######.####.###.###.................####,,##.######.#
#...........###.###........#######..................#
#####################################################