######################################
#..................#.................#
#.....#............#...........#.....#
#.....#........................#.....#
#.##################################.#
#....................................#
#.##################################.#
#.....#........................#.....#
#.....#............#...........#.....#
#..................#.................#
######################################