##########################################################
#########........#######################...###############
###########.####.........###########.....#.######...######
###########.#######..##...............####........#.######
###########..#####..#####..########################.######
###................####.#....########..................###
#.......######..#.........##...........############.##.###
#......#######...#####.###..........###########.....##.###
######...#######.#####...######.####.........##.######...#
################..######...###..#####...###.##.......###.#
#################.......##.........####........####..###.#
#######################..#########.####...####.#####.###.#
#####################...###..###.....##.#####..#####.....#
#######################...#......##...........############
#########################...##########..#....#############
#########################.############.......#############
##########################################################
##########################################################