##########################################################
#.#...............#.........#...................#.......##
#####.###########.#.#######.#.......#.###.#.#####.#####..#
#.#.#.###############.........###...#.###.#.....#.#...##.#
#.#.#.....#######.###########.......#.###.#####.#.#.#.#..#
#.#.#####.#######......#......####.##.....##.##...#.#.#.##
#.........#######.###########.####..########.##.#.#.#.#..#
#########.........###########.#####.#....###.##.#.#.#.##.#
#.......########..............#####.#.######.##.#.#.#.#..#
#.#####.########........#####...........####.##.###.#.#.##
#...................###############.#. . .##......#.#.#..#
#.####.#######.......##.###########.#.###.##......#.#.##.#
#.####.####.###.###..##.#...........####..##.######.#.#..#
#....#......###.###..##...########.......#...##.....#.#.##
####.#.########.###.....H..##...##.#####.#......###......#
#....#......###.###.######.##...##.#####...####.###.#.##.#
#......####.....###...........####.......######.###.#....#
##########################################################