################################################
#.......####...#####...#........#..............#
######...##..#...#####........  #...######....##
#..........,.....#####..#......#......#####..###
#...####....###..........######.....####.....###
#...##....#####....####.......####.............#
##........######...########.....####...#####...#
##....##########..###########...###......###..##
#........#######......................######...#
#.####..................#######..####...######.#
#.###....####.......###########....####...##...#
#.......######..........##########.####...##.###
######......#######..##...................##.###
#.........#######..........######.............##
################################################